NO textures/mor2.xpm
SO textures/south.xpm
WE textures/mor7.xpm
EA textures/wall10.xpm

F 09,09,09
C 22,12,12

111111111111111111111111111111111111
101010101010101010111111111111111111
101010101010101010111111111111111111
101010101010101010111111111111111111
101010101010101010111111111111111111
101010101010101010111111111111111111
101010101010101010111111111111111111
101010101010101010111111111111111111
101010101010101010111111111111111111
101010101010101010111111111111111111
101010101010101010111111111111111111
101010101010101010111111111111111111
101010101010101010111111111111111111
101010101010101010111111111111111111
101010101010101010111111111111111111
101010101010101010111111111111111111
101010101010101010111111111111111111
101010101010101010111111111111111111
101010101010101010111111111111111111
101010101010101010111111111111111111
101010101010101010111111111111111111
101010101010101010111111111111111111
101010101010101010111111111111111111
101010101010101010111111111111111111
101010101010101010111111111111111111
101010101010101010111111111111111111
101010101010101010111111111111111111
101010101010101010111111111111111111
101010101010101010111111111111111111
101010101010101010111111111111111111
101010101010101010111111111111111111
101010101010101010111111111111111111
101010101010101010111111111111111111
101010101010101010111111111111111111
101010101010101010111111111111111111
101010101010101010111111111111111111
101010101010101010111111111111111111
101010101010101010111111111111111111
101010101010101010111111111111111111
101010101010101010111111111111111111
101010101010101010111111111111111111
101010101010101010111111111111111111
101010101010101010111111111111111111
101010101010101010111111111111111111
101010101010101010111111111111111111
101010101010101010111111111111111111
101010101010101010111111111111111111
101010101010101010111111111111111111
101010101010101010111111111111111111
101010101010101010111111111111111111
101010101010101010111111111111111111
101010101010101010111111111111111111
101010101010101010111111111111111111
101010101010101010111111111111111111
101010101010101010111111111111111111
101010101010101010111111111111111111
101010101010101010111111111111111111
101010101010101010111111111111111111
101010101010101010111111111111111111
101010101010101010111111111111111111
101010101010101010111111111111111111
101010101010101010111111111111111111
101010101010101010111111111111111111
101010101010101010111111111111111111
101010101010101010111111111111111111
1010101010101010101001000001000001001
1010101010101010101001001001001001001
1010101010101010101000001001001000001
1010101010101010101001001000001001001
1010101010101010101000000000000000001
1010101010101010101000011111111000001
1010101010101010101111000000000001111111111111111111111
101010101010101010100000010101000000D00011111E000000001
10101010101010101010111111111111111111101111110000000001
101010101010101010101111101111111111111011111110000000001
1000000000000000001011110001111111111110111111110000000001
10000000000000000010111000001111111111101111111110000000001
1000000000000000001011000000011111111110111111110000000001
100000000000000000101000010000111111111011111110000000001
100000000000000000100000111000011111111011111110000000001
100000000000000000D0000111110000D00000000000D0000000001
1000000000000000001000001110000111111111111111111111111
1000000000000000001D1000010000111
100000000000000000101100000001111
100000000000000000101110000011111
100000000000000000101111000111111
101010101010101010101111101111111
101010101010101010101111111111111
1010101010101010101D11111111111111111111111
1010101010101010101000110000100000000000001
1010101010101010101000110000000000111111001
1010101010101010101000110000000000110001001111111111
1010101010101010101000000000D00000000001000000000001
1010101010101010101111111111111111111111111111111101
1010101010101010101000000000000000000000000000000001
1010101010101010101000000000000000000000000001000001
1010101010101010101000000000000000000000000000000001
1010101010101010101000000000000000000000001000000001
1010101010101010101000000000000000000000000000000001
1010101010101010101000000000000000000001000000000001
1010101010101010101000000000000000000000000000000001
1010101010101010101000000000000000001000000000000001
1010101010101010101000000000000000000000000000000001
1010101010101010101000000000000001000000000000000001
1010101010101010101000000000000000000000000000000001
1010101010101010101000000000001000000000000000000001
1010101010101010101000000000000000000000000000000001
1010101010101010101000000000100000000000000000000001
1010101010101010101000000000000000000000000000000001
1010101010101010101000000010000000000000000000000001
1010101010101010101000000000000000000000000000000001
1010101010101010101000001000000000000000000000000001
1010101010101010101000000000000000000000000000000001
1010101010101010101000100000000000000000000000000001
1010101010101010101000000000111100000000000000000001
1010101010101010101111111111111111111111111111111111
1010101010101010101111111111111111111111111111111111
1010101010101010101111111111111111111111111111111111
1010101010101010101111111111111111111111111111111111
1010101010101010101111111111111111111111111111111111
1010101010101010101111111111111111111111111111111111
1010101010101010101111111111111111111111111111111111
1010101010101010101111111111111111111111111111111111
1010101010101010101111111111111111111111111111111111
1010101010101010101111111111111111111111111111111111
1010101010101010101111111111111111111111111111111111
1010101010101010101111111111111111111111111111111111
1010101010101010101111111111111111111111111111111111
1010101010101010101111111111111111111111111111111111
1010101010101010101111111111111111111111111111111111
1010101010101010101111111111111111111111111111111111
1010101010101010101111111111111111111111111111111111
1010101010101010101111111111111111111111111111111111
1010101010101010101111111111111111111111111111111111
1010101010101010101111111111111111111111111111111111
1010101010101010101111111111111111111111111111111111
1010101010101010101111111111111111111111111111111111
1010101010101010101111111111111111111111111111111111
1010101010101010101111111111111111111111111111111111
1010101010101010101111111111111111111111111111111111
1010101010101010101111111111111111111111111111111111
1010101010101010101111111111111111111111111111111111
1010101010101010101111111111111111111111111111111111
1010101010101010101111111111111111111111111111111111
1010101010101010101111111111111111111111111111111111
1010101010101010101111111111111111111111111111111111
1010101010101010101111111111111111111111111111111111
1010101010101010101111111111111111111111111111111111
1010101010101010101111111111111111111111111111111111
1010101010101010101111111111111111111111111111111111
1010101010101010101111111111111111111111111111111111
1010101010101010101111111111111111111111111111111111
1010101010101010101111111111111111111111111111111111
1010101010101010101111111111111111111111111111111111
1010101010101010101111111111111111111111111111111111
1010101010101010101111111111111111111111111111111111
1010101010101010101111111111111111111111111111111111
1010101010101010101111111111111111111111111111111111
1010101010101010101111111111111111111111111111111111
1010101010101010101111111111111111111111111111111111
1010101010101010101111111111111111111111111111111111
1010101010101010101111111111111111111111111111111111
1010101010101010101111111111111111111111111111111111
1010101010101010101111111111111111111111111111111111
1010101010101010101111111111111111111111111111111111
1111111111111111111111111111111111111111111111111111