F 09,09,09
C 22,12,12

NO textures/wall2.xpm
SO textures/wall3.xpm
EA textures/wall5.xpm
WE textures/wall4.xpm

111111111111111111111
11100000D000000000001
11101011111111110001
1111101000D0000010001
111D10101111101011101
100000101000D01000001
101111101011101111111
101000001010100000001
101011011010111110101
10101000D010100010101
101D10101010101010101
100000101010001010001
111111101011111011101
100000101000100010001
101110101110101110111
1010001000001000101S1
101011111101111010101
1000D00000D0000010001
11111D1111111111111D1
111000001000000000001
100000000000000000001
101111111111111111111111111111111111111111111111111111
1D00000000000000000000000000000000000000000000000000D1
1D1111111111111111111111111101111111111111111111111101
1D1111111111111111111111111101111111111111111111111101
1D10000000000000000D000000000000000000000000D000000001
1D1011101111111110111111111101111111111111111111111101
1DD0000000000000000000000000D0000000000000000000000001
1D1111101111111111111111111101111111111111111111111101
1000000000000000000000000000D0000000000000000000000001
111111111111111111111111111111111111111111111111111111